{
  "c121": "",
  "c125": "",
  "c161": "",
  "c233": "",
  "c234": "",
  "c235": "",
  "c236": "",
  "c240": "",
  "c242": "",
  "c245": "",
  "c246": "",
  "c247": "",
  "c255": "",
  "c262": "",
  "c263": "",
  "c287": "",
  "c291": "",
  "c295": "",
  "c359": "",
  "c458": "",
  "c479": "",
  "c564": "",
  "c565": "",
  "c566": "",
  "c569": "",
  "c570": "",
  "c571": "",
  "c603": "",
  "c604": "",
  "c605": "",
  "c624": "",
  "c631": "",
  "c660": "",
  "c681": "",
  "c735": "",
  "c740": "",
  "c753": "",
  "c755": "",
  "c756": "",
  "c757": "",
  "c758": "",
  "c759": "",
  "c760": "",
  "c761": "",
  "c762": "",
  "c763": "",
  "c764": "",
  "c765": "",
  "c766": "",
  "c767": "",
  "c768": "",
  "c769": "",
  "c770": "",
  "c771": "",
  "c772": "",
  "c774": "",
  "c775": "",
  "c776": "",
  "c779": "",
  "c780": "",
  "c781": "",
  "c782": "",
  "c783": "",
  "c784": "",
  "c785": "",
  "c786": ""
}
